|g         |
|          |
|          |
|        r |
| b        |
